"å≥çÜ","òaóÔÅiîNÅj","êºóÔÅiîNÅj","îNóÓ5çŒäKãâ","êlå˚ÅiëçêîÅj","êlå˚ÅiíjÅj","êlå˚ÅièóÅj"
"ëÂê≥",9,1920,"ëçêî",55963053,28044185,27918868
"ëÂê≥",9,1920,"0Å`4çŒ",7457715,3752627,3705088
"ëÂê≥",9,1920,"5Å`9çŒ",6856920,3467156,3389764
"ëÂê≥",9,1920,"10Å`14çŒ",6101567,3089225,3012342
"ëÂê≥",9,1920,"15Å`19çŒ",5419057,2749022,2670035
"ëÂê≥",9,1920,"20Å`24çŒ",4609310,2316479,2292831
"ëÂê≥",9,1920,"25Å`29çŒ",3923949,2008005,1915944
"ëÂê≥",9,1920,"30Å`34çŒ",3609450,1833443,1776007
"ëÂê≥",9,1920,"35Å`39çŒ",3410738,1707771,1702967
"ëÂê≥",9,1920,"40Å`44çŒ",3243764,1640254,1603510
"ëÂê≥",9,1920,"45Å`49çŒ",2658567,1340404,1318163
"ëÂê≥",9,1920,"50Å`54çŒ",2234762,1122240,1112522
"ëÂê≥",9,1920,"55Å`59çŒ",1840093,912085,928008
"ëÂê≥",9,1920,"60Å`64çŒ",1655805,803033,852772
"ëÂê≥",9,1920,"65Å`69çŒ",1312537,614479,698058
"ëÂê≥",9,1920,"70Å`74çŒ",896618,399540,497078
"ëÂê≥",9,1920,"75Å`79çŒ",482012,198253,283759
"ëÂê≥",9,1920,"80Å`84çŒ",174183,65473,108710
"ëÂê≥",9,1920,"85çŒà»è„",76006,24696,51310
"ëÂê≥",14,1925,"ëçêî",59736822,30013109,29723713
"ëÂê≥",14,1925,"0Å`4çŒ",8264583,4160479,4104104
"ëÂê≥",14,1925,"5Å`9çŒ",6924432,3491171,3433261
"ëÂê≥",14,1925,"10Å`14çŒ",6735030,3410991,3324039
"ëÂê≥",14,1925,"15Å`19çŒ",5885277,2988370,2896907
"ëÂê≥",14,1925,"20Å`24çŒ",5060527,2574799,2485728
"ëÂê≥",14,1925,"25Å`29çŒ",4393471,2256502,2136969
"ëÂê≥",14,1925,"30Å`34çŒ",3716087,1920177,1795910
"ëÂê≥",14,1925,"35Å`39çŒ",3449377,1768538,1680839
"ëÂê≥",14,1925,"40Å`44çŒ",3221765,1624224,1597541
"ëÂê≥",14,1925,"45Å`49çŒ",3055149,1539488,1515661
"ëÂê≥",14,1925,"50Å`54çŒ",2450903,1223831,1227072
"ëÂê≥",14,1925,"55Å`59çŒ",1990817,981235,1009582
"ëÂê≥",14,1925,"60Å`64çŒ",1568341,754000,814341
"ëÂê≥",14,1925,"65Å`69çŒ",1294340,601475,692865
"ëÂê≥",14,1925,"70Å`74çŒ",919180,403555,515625
"ëÂê≥",14,1925,"75Å`79çŒ",523014,213632,309382
"ëÂê≥",14,1925,"80Å`84çŒ",215834,79096,136738
"ëÂê≥",14,1925,"85çŒà»è„",68695,21546,47149
"è∫òa",5,1930,"ëçêî",64450005,32390155,32059850
"è∫òa",5,1930,"0Å`4çŒ",9011135,4543442,4467693
"è∫òa",5,1930,"5Å`9çŒ",7767085,3914786,3852299
"è∫òa",5,1930,"10Å`14çŒ",6801045,3436560,3364485
"è∫òa",5,1930,"15Å`19çŒ",6539604,3318663,3220941
"è∫òa",5,1930,"20Å`24çŒ",5531506,2815406,2716100
"è∫òa",5,1930,"25Å`29çŒ",4835634,2480757,2354877
"è∫òa",5,1930,"30Å`34çŒ",4213665,2175040,2038625
"è∫òa",5,1930,"35Å`39çŒ",3584833,1856905,1727928
"è∫òa",5,1930,"40Å`44çŒ",3286478,1687934,1598544
"è∫òa",5,1930,"45Å`49çŒ",3046263,1525157,1521106
"è∫òa",5,1930,"50Å`54çŒ",2830694,1410576,1420118
"è∫òa",5,1930,"55Å`59çŒ",2216103,1085866,1130237
"è∫òa",5,1930,"60Å`64çŒ",1722085,820315,901770
"è∫òa",5,1930,"65Å`69çŒ",1255830,577193,678637
"è∫òa",5,1930,"70Å`74çŒ",926601,403984,522617
"è∫òa",5,1930,"75Å`79çŒ",551718,222451,329267
"è∫òa",5,1930,"80Å`84çŒ",245461,89183,156278
"è∫òa",5,1930,"85çŒà»è„",84265,25937,58328
"è∫òa",10,1935,"ëçêî",69254148,34734133,34520015
"è∫òa",10,1935,"0Å`4çŒ",9328501,4714001,4614500
"è∫òa",10,1935,"5Å`9çŒ",8531419,4303263,4228156
"è∫òa",10,1935,"10Å`14çŒ",7685247,3876774,3808473
"è∫òa",10,1935,"15Å`19çŒ",6640917,3350713,3290204
"è∫òa",10,1935,"20Å`24çŒ",6071071,3036783,3034288
"è∫òa",10,1935,"25Å`29çŒ",5240083,2670248,2569835
"è∫òa",10,1935,"30Å`34çŒ",4632637,2379492,2253145
"è∫òa",10,1935,"35Å`39çŒ",4045846,2093446,1952400
"è∫òa",10,1935,"40Å`44çŒ",3406011,1767627,1638384
"è∫òa",10,1935,"45Å`49çŒ",3112834,1591179,1521655
"è∫òa",10,1935,"50Å`54çŒ",2832875,1404376,1428499
"è∫òa",10,1935,"55Å`59çŒ",2571137,1255092,1316045
"è∫òa",10,1935,"60Å`64çŒ",1930611,916820,1013791
"è∫òa",10,1935,"65Å`69çŒ",1387092,630008,757084
"è∫òa",10,1935,"70Å`74çŒ",913423,394223,519200
"è∫òa",10,1935,"75Å`79çŒ",561804,224829,336975
"è∫òa",10,1935,"80Å`84çŒ",263979,95043,168936
"è∫òa",10,1935,"85çŒà»è„",98661,30216,68445
"è∫òa",15,1940,"ëçêî",73075071,36540561,36534510
"è∫òa",15,1940,"0Å`4çŒ",9128009,4619512,4508497
"è∫òa",15,1940,"5Å`9çŒ",8833598,4463439,4370159
"è∫òa",15,1940,"10Å`14çŒ",8407101,4242585,4164516
"è∫òa",15,1940,"15Å`19çŒ",7409277,3717483,3691794
"è∫òa",15,1940,"20Å`24çŒ",6103653,3057395,3046258
"è∫òa",15,1940,"25Å`29çŒ",5653184,2837267,2815917
"è∫òa",15,1940,"30Å`34çŒ",4947256,2507243,2440013
"è∫òa",15,1940,"35Å`39çŒ",4422887,2260747,2162140
"è∫òa",15,1940,"40Å`44çŒ",3834058,1976906,1857152
"è∫òa",15,1940,"45Å`49çŒ",3207212,1649661,1557551
"è∫òa",15,1940,"50Å`54çŒ",2887219,1456632,1430587
"è∫òa",15,1940,"55Å`59çŒ",2559541,1240737,1318804
"è∫òa",15,1940,"60Å`64çŒ",2227412,1049207,1178205
"è∫òa",15,1940,"65Å`69çŒ",1555162,702545,852617
"è∫òa",15,1940,"70Å`74çŒ",994906,421186,573720
"è∫òa",15,1940,"75Å`79çŒ",546408,215952,330456
"è∫òa",15,1940,"80Å`84çŒ",254127,90602,163525
"è∫òa",15,1940,"85çŒà»è„",103099,31023,72076
"è∫òa",20,1945,"ëçêî",71998104,33894059,38104045
"è∫òa",20,1945,"0Å`4çŒ",9250418,4682797,4567621
"è∫òa",20,1945,"5Å`9çŒ",8581401,4338961,4242440
"è∫òa",20,1945,"10Å`14çŒ",8645267,4365844,4279423
"è∫òa",20,1945,"15Å`19çŒ",7820530,3849481,3971049
"è∫òa",20,1945,"20Å`24çŒ",5464684,2024120,3440564
"è∫òa",20,1945,"25Å`29çŒ",4415159,1603664,2811495
"è∫òa",20,1945,"30Å`34çŒ",4447337,1805587,2641750
"è∫òa",20,1945,"35Å`39çŒ",4307705,1982773,2324932
"è∫òa",20,1945,"40Å`44çŒ",4090208,2046909,2043299
"è∫òa",20,1945,"45Å`49çŒ",3586926,1829696,1757230
"è∫òa",20,1945,"50Å`54çŒ",2948808,1506234,1442574
"è∫òa",20,1945,"55Å`59çŒ",2597278,1289547,1307731
"è∫òa",20,1945,"60Å`64çŒ",2142268,1005064,1137204
"è∫òa",20,1945,"65Å`69çŒ",1732394,775188,957206
"è∫òa",20,1945,"70Å`74çŒ",1095138,462867,632271
"è∫òa",20,1945,"75Å`79çŒ",551891,214842,337049
"è∫òa",20,1945,"80Å`84çŒ",236741,84073,152668
"è∫òa",20,1945,"85çŒà»è„",83951,26412,57539
"è∫òa",25,1950,"ëçêî",84114574,41241192,42873382
"è∫òa",25,1950,"0Å`4çŒ",11350580,5792551,5558029
"è∫òa",25,1950,"5Å`9çŒ",9624478,4877311,4747167
"è∫òa",25,1950,"10Å`14çŒ",8811354,4456939,4354415
"è∫òa",25,1950,"15Å`19çŒ",8669445,4367794,4301651
"è∫òa",25,1950,"20Å`24çŒ",7804536,3871815,3932721
"è∫òa",25,1950,"25Å`29çŒ",6246288,2847983,3398305
"è∫òa",25,1950,"30Å`34çŒ",5254401,2382599,2871802
"è∫òa",25,1950,"35Å`39çŒ",5095018,2396611,2698407
"è∫òa",25,1950,"40Å`44çŒ",4525471,2217547,2307924
"è∫òa",25,1950,"45Å`49çŒ",4042374,2035222,2007152
"è∫òa",25,1950,"50Å`54çŒ",3421396,1733836,1687560
"è∫òa",25,1950,"55Å`59çŒ",2780034,1392572,1387462
"è∫òa",25,1950,"60Å`64çŒ",2329349,1120403,1208946
"è∫òa",25,1950,"65Å`69çŒ",1789948,803800,986148
"è∫òa",25,1950,"70Å`74çŒ",1295651,545748,749903
"è∫òa",25,1950,"75Å`79çŒ",693679,270523,423156
"è∫òa",25,1950,"80Å`84çŒ",279254,96600,182654
"è∫òa",25,1950,"85çŒà»è„",96512,29003,67509
"è∫òa",30,1955,"ëçêî",90076594,44242657,45833937
"è∫òa",30,1955,"0Å`4çŒ",9381512,4794426,4587086
"è∫òa",30,1955,"5Å`9çŒ",11156015,5694447,5461568
"è∫òa",30,1955,"10Å`14çŒ",9585370,4855556,4729814
"è∫òa",30,1955,"15Å`19çŒ",8709075,4383128,4325947
"è∫òa",30,1955,"20Å`24çŒ",8475954,4231701,4244253
"è∫òa",30,1955,"25Å`29çŒ",7663079,3802724,3860355
"è∫òa",30,1955,"30Å`34çŒ",6162622,2817154,3345468
"è∫òa",30,1955,"35Å`39çŒ",5154689,2336529,2818160
"è∫òa",30,1955,"40Å`44çŒ",4980506,2340429,2640077
"è∫òa",30,1955,"45Å`49çŒ",4397993,2149102,2248891
"è∫òa",30,1955,"50Å`54çŒ",3876779,1941081,1935698
"è∫òa",30,1955,"55Å`59çŒ",3228362,1617760,1610602
"è∫òa",30,1955,"60Å`64çŒ",2517556,1235983,1281573
"è∫òa",30,1955,"65Å`69çŒ",1982599,925400,1057199
"è∫òa",30,1955,"70Å`74çŒ",1392662,593776,798886
"è∫òa",30,1955,"75Å`79çŒ",875701,342059,533642
"è∫òa",30,1955,"80Å`84çŒ",377787,133192,244595
"è∫òa",30,1955,"85çŒà»è„",134122,39681,94441
"è∫òa",35,1960,"ëçêî",94301623,46300445,48001178
"è∫òa",35,1960,"0Å`4çŒ",7964828,4073749,3891079
"è∫òa",35,1960,"5Å`9çŒ",9339141,4770578,4568563
"è∫òa",35,1960,"10Å`14çŒ",11130190,5677909,5452281
"è∫òa",35,1960,"15Å`19çŒ",9379673,4713854,4665819
"è∫òa",35,1960,"20Å`24çŒ",8390982,4160096,4230886
"è∫òa",35,1960,"25Å`29çŒ",8279524,4129166,4150358
"è∫òa",35,1960,"30Å`34çŒ",7575693,3774040,3801653
"è∫òa",35,1960,"35Å`39çŒ",6083135,2782870,3300265
"è∫òa",35,1960,"40Å`44çŒ",5057947,2291120,2766827
"è∫òa",35,1960,"45Å`49çŒ",4850813,2271959,2578854
"è∫òa",35,1960,"50Å`54çŒ",4231204,2053737,2177467
"è∫òa",35,1960,"55Å`59çŒ",3667376,1813371,1854005
"è∫òa",35,1960,"60Å`64çŒ",2953008,1446757,1506251
"è∫òa",35,1960,"65Å`69çŒ",2179290,1035042,1144248
"è∫òa",35,1960,"70Å`74çŒ",1577027,698672,878355
"è∫òa",35,1960,"75Å`79çŒ",963397,379767,583630
"è∫òa",35,1960,"80Å`84çŒ",487663,170599,317064
"è∫òa",35,1960,"85çŒà»è„",190603,57103,133500
"è∫òa",40,1965,"ëçêî",99209137,48692138,50516999
"è∫òa",40,1965,"0Å`4çŒ",8241607,4204772,4036835
"è∫òa",40,1965,"5Å`9çŒ",7970120,4056194,3913926
"è∫òa",40,1965,"10Å`14çŒ",9317503,4738325,4579178
"è∫òa",40,1965,"15Å`19çŒ",10947996,5527355,5420641
"è∫òa",40,1965,"20Å`24çŒ",9127519,4523969,4603550
"è∫òa",40,1965,"25Å`29çŒ",8435227,4191561,4243666
"è∫òa",40,1965,"30Å`34çŒ",8324917,4180969,4143948
"è∫òa",40,1965,"35Å`39çŒ",7553997,3773472,3780525
"è∫òa",40,1965,"40Å`44çŒ",6005021,2748642,3256379
"è∫òa",40,1965,"45Å`49çŒ",4959332,2240740,2718592
"è∫òa",40,1965,"50Å`54çŒ",4691471,2187487,2503984
"è∫òa",40,1965,"55Å`59çŒ",4030134,1942543,2087591
"è∫òa",40,1965,"60Å`64çŒ",3368628,1635046,1733582
"è∫òa",40,1965,"65Å`69çŒ",2581466,1226741,1354725
"è∫òa",40,1965,"70Å`74çŒ",1760618,795372,965246
"è∫òa",40,1965,"75Å`79çŒ",1106137,455411,650726
"è∫òa",40,1965,"80Å`84çŒ",533914,188750,345164
"è∫òa",40,1965,"85çŒà»è„",253479,74765,178714
"è∫òa",45,1970,"ëçêî",104665171,51369177,53295994
"è∫òa",45,1970,"0Å`4çŒ",8907564,4564915,4342649
"è∫òa",45,1970,"5Å`9çŒ",8267336,4225903,4041433
"è∫òa",45,1970,"10Å`14çŒ",7977879,4066571,3911308
"è∫òa",45,1970,"15Å`19çŒ",9167044,4622873,4544171
"è∫òa",45,1970,"20Å`24çŒ",10727636,5344885,5382751
"è∫òa",45,1970,"25Å`29çŒ",9148198,4545780,4602418
"è∫òa",45,1970,"30Å`34çŒ",8441333,4215776,4225557
"è∫òa",45,1970,"35Å`39çŒ",8272842,4154678,4118164
"è∫òa",45,1970,"40Å`44çŒ",7393628,3690875,3702753
"è∫òa",45,1970,"45Å`49çŒ",5919697,2696819,3222878
"è∫òa",45,1970,"50Å`54çŒ",4841390,2172383,2669007
"è∫òa",45,1970,"55Å`59çŒ",4455213,2055135,2400078
"è∫òa",45,1970,"60Å`64çŒ",3752119,1766393,1985726
"è∫òa",45,1970,"65Å`69çŒ",3005586,1407870,1597716
"è∫òa",45,1970,"70Å`74çŒ",2150406,968076,1182330
"è∫òa",45,1970,"75Å`79çŒ",1280431,536369,744062
"è∫òa",45,1970,"80Å`84çŒ",656578,243532,413046
"è∫òa",45,1970,"85çŒà»è„",300291,90344,209947
"è∫òa",50,1975,"ëçêî",111939643,55090673,56848970
"è∫òa",50,1975,"0Å`4çŒ",10000607,5127359,4873248
"è∫òa",50,1975,"5Å`9çŒ",8938021,4583653,4354368
"è∫òa",50,1975,"10Å`14çŒ",8282064,4237041,4045023
"è∫òa",50,1975,"15Å`19çŒ",7948546,4040280,3908266
"è∫òa",50,1975,"20Å`24çŒ",9071509,4563526,4507983
"è∫òa",50,1975,"25Å`29çŒ",10794583,5426289,5368294
"è∫òa",50,1975,"30Å`34çŒ",9245791,4624591,4621200
"è∫òa",50,1975,"35Å`39çŒ",8422320,4212566,4209754
"è∫òa",50,1975,"40Å`44çŒ",8224070,4125063,4099007
"è∫òa",50,1975,"45Å`49çŒ",7361410,3656501,3704909
"è∫òa",50,1975,"50Å`54çŒ",5781705,2616771,3164934
"è∫òa",50,1975,"55Å`59çŒ",4673649,2072676,2600973
"è∫òa",50,1975,"60Å`64çŒ",4283734,1935823,2347911
"è∫òa",50,1975,"65Å`69çŒ",3449037,1571228,1877809
"è∫òa",50,1975,"70Å`74çŒ",2575882,1147922,1427960
"è∫òa",50,1975,"75Å`79çŒ",1641007,688306,952701
"è∫òa",50,1975,"80Å`84çŒ",808703,307763,500940
"è∫òa",50,1975,"85çŒà»è„",390800,122647,268153
"è∫òa",55,1980,"ëçêî",117060396,57593769,59466627
"è∫òa",55,1980,"0Å`4çŒ",8515416,4366100,4149316
"è∫òa",55,1980,"5Å`9çŒ",10032034,5142487,4889547
"è∫òa",55,1980,"10Å`14çŒ",8959628,4594813,4364815
"è∫òa",55,1980,"15Å`19çŒ",8272245,4223685,4048560
"è∫òa",55,1980,"20Å`24çŒ",7841026,3960116,3880910
"è∫òa",55,1980,"25Å`29çŒ",9041355,4545468,4495887
"è∫òa",55,1980,"30Å`34çŒ",10771731,5421545,5350186
"è∫òa",55,1980,"35Å`39çŒ",9201581,4594716,4606865
"è∫òa",55,1980,"40Å`44çŒ",8337500,4158990,4178510
"è∫òa",55,1980,"45Å`49çŒ",8090387,4033146,4057241
"è∫òa",55,1980,"50Å`54çŒ",7200022,3546963,3653059
"è∫òa",55,1980,"55Å`59çŒ",5613505,2511379,3102126
"è∫òa",55,1980,"60Å`64çŒ",4465247,1945930,2519317
"è∫òa",55,1980,"65Å`69çŒ",3964681,1743659,2221022
"è∫òa",55,1980,"70Å`74çŒ",3022977,1317661,1705316
"è∫òa",55,1980,"75Å`79çŒ",2036685,848714,1187971
"è∫òa",55,1980,"80Å`84çŒ",1093643,417715,675928
"è∫òa",55,1980,"85çŒà»è„",529370,171959,357411
"è∫òa",60,1985,"ëçêî",121048923,59497316,61551607
"è∫òa",60,1985,"0Å`4çŒ",7459263,3818777,3640486
"è∫òa",60,1985,"5Å`9çŒ",8531834,4373058,4158776
"è∫òa",60,1985,"10Å`14çŒ",10042121,5146970,4895151
"è∫òa",60,1985,"15Å`19çŒ",8979947,4600427,4379520
"è∫òa",60,1985,"20Å`24çŒ",8200554,4165995,4034559
"è∫òa",60,1985,"25Å`29çŒ",7823402,3948330,3875072
"è∫òa",60,1985,"30Å`34çŒ",9054224,4558265,4495959
"è∫òa",60,1985,"35Å`39çŒ",10738044,5398230,5339814
"è∫òa",60,1985,"40Å`44çŒ",9134954,4551877,4583077
"è∫òa",60,1985,"45Å`49çŒ",8236614,4092121,4144493
"è∫òa",60,1985,"50Å`54çŒ",7932994,3926414,4006580
"è∫òa",60,1985,"55Å`59çŒ",6999745,3409374,3590371
"è∫òa",60,1985,"60Å`64çŒ",5405538,2379902,3025636
"è∫òa",60,1985,"65Å`69çŒ",4193419,1781008,2412411
"è∫òa",60,1985,"70Å`74çŒ",3563397,1503595,2059802
"è∫òa",60,1985,"75Å`79çŒ",2493343,1017428,1475915
"è∫òa",60,1985,"80Å`84çŒ",1432937,542243,890694
"è∫òa",60,1985,"85çŒà»è„",785247,255975,529272
"ïΩê¨",2,1990,"ëçêî",123611167,60696724,62914443
"ïΩê¨",2,1990,"0Å`4çŒ",6492897,3326039,3166858
"ïΩê¨",2,1990,"5Å`9çŒ",7466557,3821833,3644724
"ïΩê¨",2,1990,"10Å`14çŒ",8526785,4369880,4156905
"ïΩê¨",2,1990,"15Å`19çŒ",10007087,5122215,4884872
"ïΩê¨",2,1990,"20Å`24çŒ",8800121,4468199,4331922
"ïΩê¨",2,1990,"25Å`29çŒ",8070713,4078469,3992244
"ïΩê¨",2,1990,"30Å`34çŒ",7787685,3925353,3862332
"ïΩê¨",2,1990,"35Å`39çŒ",9003780,4524829,4478951
"ïΩê¨",2,1990,"40Å`44çŒ",10658290,5349985,5308305
"ïΩê¨",2,1990,"45Å`49çŒ",9018012,4482298,4535714
"ïΩê¨",2,1990,"50Å`54çŒ",8088386,3997248,4091138
"ïΩê¨",2,1990,"55Å`59çŒ",7724888,3783367,3941521
"ïΩê¨",2,1990,"60Å`64çŒ",6745014,3236549,3508465
"ïΩê¨",2,1990,"65Å`69çŒ",5103576,2194783,2908793
"ïΩê¨",2,1990,"70Å`74çŒ",3817534,1559972,2257562
"ïΩê¨",2,1990,"75Å`79çŒ",3018213,1197457,1820756
"ïΩê¨",2,1990,"80Å`84çŒ",1832858,678385,1154473
"ïΩê¨",2,1990,"85çŒà»è„",1122414,357040,765374
"ïΩê¨",7,1995,"ëçêî",125570246,61574398,63995848
"ïΩê¨",7,1995,"0Å`4çŒ",5995254,3070015,2925239
"ïΩê¨",7,1995,"5Å`9çŒ",6540671,3349827,3190844
"ïΩê¨",7,1995,"10Å`14çŒ",7477805,3826968,3650837
"ïΩê¨",7,1995,"15Å`19çŒ",8557958,4385775,4172183
"ïΩê¨",7,1995,"20Å`24çŒ",9895001,5041228,4853773
"ïΩê¨",7,1995,"25Å`29çŒ",8788141,4452125,4336016
"ïΩê¨",7,1995,"30Å`34çŒ",8126455,4113849,4012606
"ïΩê¨",7,1995,"35Å`39çŒ",7822221,3945809,3876412
"ïΩê¨",7,1995,"40Å`44çŒ",9006072,4527352,4478720
"ïΩê¨",7,1995,"45Å`49çŒ",10618366,5328335,5290031
"ïΩê¨",7,1995,"50Å`54çŒ",8921918,4421787,4500131
"ïΩê¨",7,1995,"55Å`59çŒ",7953480,3906621,4046859
"ïΩê¨",7,1995,"60Å`64çŒ",7475109,3611948,3863161
"ïΩê¨",7,1995,"65Å`69çŒ",6396078,2998706,3397372
"ïΩê¨",7,1995,"70Å`74çŒ",4695167,1941558,2753609
"ïΩê¨",7,1995,"75Å`79çŒ",3289067,1260411,2028656
"ïΩê¨",7,1995,"80Å`84çŒ",2300765,824492,1476273
"ïΩê¨",7,1995,"85çŒà»è„",1579745,479086,1100659
"ïΩê¨",12,2000,"ëçêî",126925843,62110764,64815079
"ïΩê¨",12,2000,"0Å`4çŒ",5904098,3022521,2881577
"ïΩê¨",12,2000,"5Å`9çŒ",6021789,3083431,2938358
"ïΩê¨",12,2000,"10Å`14çŒ",6546612,3353150,3193462
"ïΩê¨",12,2000,"15Å`19çŒ",7488165,3833984,3654181
"ïΩê¨",12,2000,"20Å`24çŒ",8421460,4307242,4114218
"ïΩê¨",12,2000,"25Å`29çŒ",9790309,4965277,4825032
"ïΩê¨",12,2000,"30Å`34çŒ",8776610,4436818,4339792
"ïΩê¨",12,2000,"35Å`39çŒ",8114865,4096286,4018579
"ïΩê¨",12,2000,"40Å`44çŒ",7800219,3924171,3876048
"ïΩê¨",12,2000,"45Å`49çŒ",8916008,4467772,4448236
"ïΩê¨",12,2000,"50Å`54çŒ",10441990,5210038,5231952
"ïΩê¨",12,2000,"55Å`59çŒ",8734172,4290239,4443933
"ïΩê¨",12,2000,"60Å`64çŒ",7735833,3749528,3986305
"ïΩê¨",12,2000,"65Å`69çŒ",7105939,3357281,3748658
"ïΩê¨",12,2000,"70Å`74çŒ",5900576,2670270,3230306
"ïΩê¨",12,2000,"75Å`79çŒ",4150600,1625822,2524778
"ïΩê¨",12,2000,"80Å`84çŒ",2614689,915268,1699421
"ïΩê¨",12,2000,"85çŒà»è„",2233348,653475,1579873
"ïΩê¨",17,2005,"ëçêî",127767994,62348977,65419017
"ïΩê¨",17,2005,"0Å`4çŒ",5578087,2854502,2723585
"ïΩê¨",17,2005,"5Å`9çŒ",5928495,3036503,2891992
"ïΩê¨",17,2005,"10Å`14çŒ",6014652,3080678,2933974
"ïΩê¨",17,2005,"15Å`19çŒ",6568380,3373430,3194950
"ïΩê¨",17,2005,"20Å`24çŒ",7350598,3754822,3595776
"ïΩê¨",17,2005,"25Å`29çŒ",8280049,4198551,4081498
"ïΩê¨",17,2005,"30Å`34çŒ",9754857,4933265,4821592
"ïΩê¨",17,2005,"35Å`39çŒ",8735781,4402787,4332994
"ïΩê¨",17,2005,"40Å`44çŒ",8080596,4065470,4015126
"ïΩê¨",17,2005,"45Å`49çŒ",7725861,3867500,3858361
"ïΩê¨",17,2005,"50Å`54çŒ",8796499,4383240,4413259
"ïΩê¨",17,2005,"55Å`59çŒ",10255164,5077369,5177795
"ïΩê¨",17,2005,"60Å`64çŒ",8544629,4154529,4390100
"ïΩê¨",17,2005,"65Å`69çŒ",7432610,3545006,3887604
"ïΩê¨",17,2005,"70Å`74çŒ",6637497,3039743,3597754
"ïΩê¨",17,2005,"75Å`79çŒ",5262801,2256317,3006484
"ïΩê¨",17,2005,"80Å`84çŒ",3412393,1222635,2189758
"ïΩê¨",17,2005,"85Å`89çŒ",1849260,555126,1294134
"ïΩê¨",17,2005,"90Å`94çŒ",840870,210586,630284
"ïΩê¨",17,2005,"95Å`99çŒ",211221,41426,169795
"ïΩê¨",17,2005,"100Å`104çŒ",23873,3580,20293
"ïΩê¨",17,2005,"105Å`109çŒ",1458,178,1280
"ïΩê¨",17,2005,"110çŒà»è„",22,2,20
"ïΩê¨",22,2010,"ëçêî",128057352,62327737,65729615
"ïΩê¨",22,2010,"0Å`4çŒ",5296748,2710581,2586167
"ïΩê¨",22,2010,"5Å`9çŒ",5585661,2859805,2725856
"ïΩê¨",22,2010,"10Å`14çŒ",5921035,3031943,2889092
"ïΩê¨",22,2010,"15Å`19çŒ",6063357,3109229,2954128
"ïΩê¨",22,2010,"20Å`24çŒ",6426433,3266240,3160193
"ïΩê¨",22,2010,"25Å`29çŒ",7293701,3691723,3601978
"ïΩê¨",22,2010,"30Å`34çŒ",8341497,4221011,4120486
"ïΩê¨",22,2010,"35Å`39çŒ",9786349,4950122,4836227
"ïΩê¨",22,2010,"40Å`44çŒ",8741865,4400375,4341490
"ïΩê¨",22,2010,"45Å`49çŒ",8033116,4027969,4005147
"ïΩê¨",22,2010,"50Å`54çŒ",7644499,3809576,3834923
"ïΩê¨",22,2010,"55Å`59çŒ",8663734,4287489,4376245
"ïΩê¨",22,2010,"60Å`64çŒ",10037249,4920468,5116781
"ïΩê¨",22,2010,"65Å`69çŒ",8210173,3921774,4288399
"ïΩê¨",22,2010,"70Å`74çŒ",6963302,3225503,3737799
"ïΩê¨",22,2010,"75Å`79çŒ",5941013,2582940,3358073
"ïΩê¨",22,2010,"80Å`84çŒ",4336264,1692584,2643680
"ïΩê¨",22,2010,"85Å`89çŒ",2432588,744222,1688366
"ïΩê¨",22,2010,"90Å`94çŒ",1021707,241799,779908
"ïΩê¨",22,2010,"95Å`99çŒ",296756,55739,241017
"ïΩê¨",22,2010,"100Å`104çŒ",41318,5598,35720
"ïΩê¨",22,2010,"105Å`109çŒ",2486,250,2236
"ïΩê¨",22,2010,"110çŒà»è„",78,3,75
"ïΩê¨",27,2015,"ëçêî",127094745,61841738,65253007
"ïΩê¨",27,2015,"0Å`4çŒ",4987706,2550921,2436785
"ïΩê¨",27,2015,"5Å`9çŒ",5299787,2714591,2585196
"ïΩê¨",27,2015,"10Å`14çŒ",5599317,2868024,2731293
"ïΩê¨",27,2015,"15Å`19çŒ",6008388,3085416,2922972
"ïΩê¨",27,2015,"20Å`24çŒ",5968127,3046392,2921735
"ïΩê¨",27,2015,"25Å`29çŒ",6409612,3255717,3153895
"ïΩê¨",27,2015,"30Å`34çŒ",7290878,3684747,3606131
"ïΩê¨",27,2015,"35Å`39çŒ",8316157,4204202,4111955
"ïΩê¨",27,2015,"40Å`44çŒ",9732218,4914018,4818200
"ïΩê¨",27,2015,"45Å`49çŒ",8662804,4354877,4307927
"ïΩê¨",27,2015,"50Å`54çŒ",7930296,3968311,3961985
"ïΩê¨",27,2015,"55Å`59çŒ",7515246,3729523,3785723
"ïΩê¨",27,2015,"60Å`64çŒ",8455010,4151119,4303891
"ïΩê¨",27,2015,"65Å`69çŒ",9643867,4659662,4984205
"ïΩê¨",27,2015,"70Å`74çŒ",7695811,3582440,4113371
"ïΩê¨",27,2015,"75Å`79çŒ",6276856,2787417,3489439
"ïΩê¨",27,2015,"80Å`84çŒ",4961420,1994326,2967094
"ïΩê¨",27,2015,"85Å`89çŒ",3117257,1056641,2060616
"ïΩê¨",27,2015,"90Å`94çŒ",1349120,333335,1015785
"ïΩê¨",27,2015,"95Å`99çŒ",359347,63265,296082
"ïΩê¨",27,2015,"100Å`104çŒ",57847,7991,49856
"ïΩê¨",27,2015,"105Å`109çŒ",3770,383,3387
"ïΩê¨",27,2015,"110çŒà»è„",146,9,137
"äeîNÇÃíç"
"è∫òa15îNÅ@í©ëNÅCë‰òpÅCäíëæãyÇ—ìÏómåQìáà»äOÇÃçëê–ÇÃäOçëêl(39237êl)ÇèúÇ≠ÅuëSêlå˚ÅvÇ≈Ç†ÇÈÅB "
"è∫òa15îNÅ@îNóÓÅuïsè⁄ÅvÇä‹ÇﬁÅB"
"è∫òa20îNÅ@îNóÓÇÕêîÇ¶îNÇ≈Ç†ÇÈÅB"
"è∫òa20îNÅ@â´ìÍåßÇèúÇ≠ÅB"
"è∫òa25îNÅ@îNóÓÅuïsè⁄ÅvÇä‹ÇﬁÅB "
"è∫òa25îNÅ@â´ìÍåßÇÃ70çŒà»è„ÇÃäOçëêl136êl(íjéq55êlÅCèóéq81êl)ÇèúÇ≠ÅB"
"è∫òa30îNÅ@îNóÓÅuïsè⁄ÅvÇä‹ÇﬁÅB "
"è∫òa30îNÅ@â´ìÍåßÇèúÇ≠Åiâ´ìÍåßÇÃ70çŒà»è„ÇÃêlå˚ÇÕÅCíj8090êlÅCèó15238êl)ÅB"
"è∫òa35îNÅE40îNÅ@â´ìÍåßÇÃîNóÓÅuïsè⁄ÅvÇä‹ÇﬁÅB"
"è∫òa50îNÅ`ïΩê¨27îNÅ@îNóÓ¢ïsè⁄£Çä‹ÇﬁÅB"
